11111111111111111111111111111111111111111111111111111111111111111111111111111111111111111111111111111111111111111111111111111111111111111111
10000000000000000000000000000000000000000000000000000000000000000000000000000000000000000000000000000000000000000000000000000000000000000001
10000000000000000000000000000000000000000000000000000000000000000000000000000000000000000000000000000000000000000000000000000000000000000001
10000000000000000000000000000000000000000000000000000000000000000000000000000000000000000000000000000000000000000000000000000000000000000001
10000000000000000000000000000000000000000000000000000000000000000000000000000000000000000000000000000000000000000000000000000000000000000001
10000000000000000000000000000000000000000000000000000000000000000000000000000000000000000000000000000000000000000000000000000000000000000001
10000000000000000000000000000000000000000000000000000000000000000000000000000000000000000000000000000000000000000000000000000000000000000001
10000000000000000000000000000000000000000000000000000000000000000000000000000000000000000000000000000000000000000000000000000000000000000001
10000000000000000000000000000000000000000000000000000000000000000000000000000000000000000000000000000000000000000000000000000000000000000001
10000000000000000000000000000000000000000000000000000000000000000000000000000000000000000000000000000000000000000000000000000000000000000001
10000000000000000000000000000000000000000000000000000000000000000000000000000000000000000000000000000000000000000000000000000000000000000001
10000000000000000000000000000000000000000000000000000000000000000000000000000000000000000000000000000000000000000000000000000000000000000001
10000000000000000000000000000000000000000000000000000000000000000000000000000000000000000000000000000000000000000000000000000000000000000001
10000000000000000000000000000000000000000000000000000000000000000000000000000000000000000000000000000000000000000000000000000000000000000001
10000000000000000000000000000000000000002220022002200220002200000000000000000000000000000000000000000000000000000000000000000000000000000001
10000000000000000002222222000000000222221110011001100110001100000000000000000000000000000000000000000000000000000000000000000000000000000001
10000000000000000021111111000000000000000000000000000000000000000000000000000000000000000000000000000000000000000000000000000000000000000001
12222222222222222211111111222222222555552225522552255225552222222222222222222222222222222222000002222222222222222222222222222222222222000001
11111111111111111111111111111111111111111111111111111111111111111111111111111111111111111111000001111111111111111111111111111111111111000001
11111111111111111111111111111111111111111111111111111111111111111111111111111111111111111111000001111111111111111111111111111111111111000001
11111111111111111111111111111111111111111111111111111111111111111111111111111111111111111111000001111111111111111111111111111111111111000001
10000000000000000111100000000000000000000000000000000000000000000000000000000000000000000011000000000000000000000000000000000000000000000001
10000000000000000111100000000000000000000000000000000000000000000000000000000000000000000011000000000000000000000000000000000000000000000001
10000000000000000111100000000000000000000000000000000000000000000000200000000000000000000011000000000000000000000000000000000000000000000001
10000000000000000111100700000000000000000000000000000000000200200000120000000000000000000011000000000000000000000000000000000000000000000001
10002222222222000111122222222222262222622226222262222222255555522222116622222222222222000011200022222222222222222222222222222222222222200001
10000111111110000111111111111111111111111111111111111111111111111111111111111111111111200011000011111111111111111111111111111111111111100001
10000111111110000111100000000000000000000000000000000000000000000000000000000000000011000011000011111000000000000000000000000000000001120001
12000111111110002111100000000000000000000000000000000000000000000000000000000000000011000011000211111200000000000000000000000000000001100001
10000111111110000111100000000000000000000000000000000000000000000000000000000000000011000211000011111120000000000000000000000000070001100001
10000111111110000111100000000000000000000000000000000000000000000000000000000000000011000011000011111112000002000222222222222222222221100021
10002111111112000111122222222222222222222222222222222222222222222222222222222222000011000011200011111111200001000000000000000000000001100001
10000111111110000111111111111111111111111111111111111111111111111111111111111111000211200000000011111111120000000000000000000002222001100001
10000111111110000111111100000000000000000000000000000000000000000000000000000000000011000000000011111111112000000060000022200000000001120001
12000111111110002111110000000000000000000000000000000000000000000000000000000000006611000022222211111111111226262222225551555222000021100001
10000111111110000111100000000000000000000000000000000000000000000000000002222222222211000011111111111111111111111111111111111111000001100001
10000111111110000111100000000000000000000000000000000000000002222222222221000000000000000011000000000000000000000000000000000000000001100021
10002111111112000111100002222222222222222222222222222222222221000000000000000000000000000211000000000000000000000000000000000000000021100001
10000111111110000111120000000000000000000000000000000000000000000000000000000000000000000000000000000000000002222200000000022222200001100001
10000111111110000111100000000000000000000000000000000000000000000000000000000000000000000000000000000022222000010000000002211111100001120001
12000111111110002111100002222222222222222222222222222222222222222222222222222222222222000222222222225555551555212555222261111111166661100001
10000111111110000111100021111111111111111111111111111111111111111111111111111111111111000011111111111111111111111111111111111111111111100001
10000111111110000111100000000000000000000000000000000000000000000000000000000000000011000000000000000000000000000011111111111111111111222221
10002111111112000111120000000000000000000000000000000000000000000000000000000000000011200000000000000000000000000000000000001111111111111111
10000111111110000000000000000000000000000000000000000000000000000000000000000000000011000000000000000000000000000000000000000000000001111111
10000111111110000000000000000000000000000000000000000000000000000000000000000000000011000000000000000000000000000000000000000000000000000011
10000111111112222222222222222222222222222222222222222222222222222222222222222222222211222222222266266222222222222222222222222222222222222221
10000000000000000000000000000000000000000000000000000000000000000000000000000000000011111111111111111111111111111111111111111111111111111111
10000000000000000000000000000000000000000000000000000000000000000000000000000000000000000000000000000000000000000000000000000000000000000001
10000000000000000000000000000000000000000000000000000000000000000000000000000000000000000000000000000000000000000000000000000000000000000001
10000000000000000000000000000000000000000000000000000000000000000000000000000000000000000000000000000000000000000000000000000000000000000001
10000000000000000000000000000000000000000000000000000000000000000000000000000000000000000000000000000000000000000000000000000000000000000001
10000000000000000000000000000000000000000000000000000000000000000000000000000000000000000000000000000000000000000000000000000000000000000001
10000000000000000000000000000000000000000000000000000000000000000000000000000000000000000000000000000000000000000000000000000000000000000001
10000000000000000000000000000000000000000000000000000000000000000000000000000000000000000000000000000000000000000000000000000000000000000001
10000000000000000000000000000000000000000000000000000000000000000000000000000000000000000000000000000000000000000000000000000000000000000001
10000000000000000000000000000000000000000000000000000000000000000000000000000000000000000000000000000000000000000000000000000000000000000001
10000000000000000000000000000000000000000000000000000000000000000000000000000000000000000000000000000000000000000000000000000000000000000001
10000000000000000000000000000000000000000000000000000000000000000000000000000000000000000000000000000000000000000000000000000000000000000001
10000000000000000000000000000000000000000000000000000000000000000000000000000000000000000000000000000000000000000000000000000000000000000001
10000000000000000000000000000000000000000000000000000000000000000000000000000000000000000000000000000000000000000000000000000000000000000001
10000000000000000000000000000000000000000000000000000000000000000000000000000000000000000000000000000000000000000000000000000000000000000001
10000000000000000000000000000000000000000000000000000000000000000000000000000000000000000000000000000000000000000000000000000000000000000001
10000000000000000000000000000000000000000000000000000000000000000000000000000000000000000000000000000000000000000000000000000000000000000001
10000000000000000000000000000000000000000000000000000000000000000000000000000000000000000000000000000000000000000000000000000000000000000001
10000000000000000000000000000000000000000000000000000000000000000000000000000000000000000000000000000000000000000000000000000000000000000001
10000000000000000000000000000000000000000000000000000000000000000000000000000000000000000000000000000000000000000000000000000000000000000001
10000000000000000000000000000000000000000000000000000000000000000000000000000000000000000000000000000000000000000000000000000000000000000001
10000000000000000000000000000000000000000000000000000000000000000000000000000000000000000000000000000000000000000000000000000000000000000001
10000000000000000000000000000000000000000000000000000000000000000000000000000000000000000000000000000000000000000000000000000000000000000001
10000000000000000000000000000000000000000000000000000000000000000000000000000000000000000000000000000000000000000000000000000000000000000001
10000000000000000000000000000000000000000000000000000000000000000000000000000000000000000000000000000000000000000000000000000000000000000001
10000000000000000000000000000000000000000000000000000000000000000000000000000000000000000000000000000000000000000000000000000000000000000001
10000000000000000000000000000000000000000000000000000000000000000000000000000000000000000000000000000000000000000000000000000000000000000001
10000000000000000000000000000000000000000000000000000000000000000000000000000000000000000000000000000000000000000000000000000000000000000001
10000000000000000000000000000000000000000000000000000000000000000000000000000000000000000000000000000000000000000000000000000000000000000001
10000000000000000000000000000000000000000000000000000000000000000000000000000000000000000000000000000000000000000000000000000000000000000001
10000000000000000000000000000000000000000000000000000000000000000000000000000000000000000000000000000000000000000000000000000000000000000001
10000000000000000000000000000000000000000000000000000000000000000000000000000000000000000000000000000000000000000000000000000000000000000001
10000000000000000000000000000000000000000000000000000000000000000000000000000000000000000000000000000000000000000000000000000000000000000001
10000000000000000000000000000000000000000000000000000000000000000000000000000000000000000000000000000000000000000000000000000000000000000001
10000000000000000000000000000000000000000000000000000000000000000000000000000000000000000000000000000000000000000000000000000000000000000001
10000000000000000000000000000000000000000000000000000000000000000000000000000000000000000000000000000000000000000000000000000000000000000001
10000000000000000000000000000000000000000000000000000000000000000000000000000000000000000000000000000000000000000000000000000000000000000001
11111111111111111111111111111111111111111111111111111111111111111111111111111111111111111111111111111111111111111111111111111111111110000001
