111111111111111111111111111111111111111111111111111111111111111111111111111111111111111111111111111111111111111111111111111111111111111111111111111111111111111111111111111
111111111111111111111111111111111111111111111111111111111111111111111111111111111111111111111111111111111111111111111111111111111111111111111111111111111111111111111111111
111111111111111111111111111111111111111111111111111111111111111111111111111111111111111111111111111111111111111111111111111111111111111111111111111111111111111111111111111
111111111111111111111111111111111111111111111111111111111111111111111111111111111111111111111111111111111111111111111111111111111111111111111111111111111111111111111111111
111111111111111111111111111111111111111111111111111111111111111111111111111111111111111111111111111111111111111111111111111111111111111111111111111111111111111111111111111
111111111111111111111111111111111111111111111111111111111111111111111111111111111111111111111111111111111111111111111111111111111111111111111111111111111111111111111111111
111111111111111111111111111111111111111111111111111111111111111111111111111111111111111111111111111111111111111111111111111111111111111111111111111111111111111111111111111
111111111111111111111111111111111111111111111111111111111111111111111111111111111111111111111111111111111111111111111111111111111111111111111111111111111111111111111111111
111111111111111100000000000000000000000000000000000000000000000000000000000000000000000000000000000000000000000000000000000000000000000000000000000000000011111111111111111
111111111111111100000000000000000000000000000000000000000000000000000000000000000000000000000000000000000000000000000000000000000000000000000000000000000011111111111111111
111111111111111100000000000000000000000000000000000000000000000000000000000000000000000000000000000000000000000000000000000000000000000000000000000000000011111111111111111
111111111111111100000000000000000000000000000000000000000000000000000000000000000000000000000000000000000000000000000000000000000000000000000000000000000011111111111111111
111111111111111100000000000000000000000000000000000000000000000000000000000000000000000000000000000000000000000000000000000000000000000000000000000000000011111111111111111
111111111111111100000000000000000000000000000000000000022200220022002200022000000000000000000000000000000000000000000000000000000000000000000000000000000011111111111111111
111111111111111100000000000000000022222220000000002222211100110011001100011000000000000000000000000000000000000000000000000000000000000000000000000000000011111111111111111
111111111111111100000000000000000211111110000000000000000000000000000000000000000000000000000000000000000000000000000000000000000000000000000000000000000011111111111111111
111111111111111122222222222222222111111112222222225555522255225522552255522222222222222222222222222222222220000022222222222222222222222222222222222220000011111111111111111
111111111111111111111111111111111111111111111111111111111111111111111111111111111111111111111111111111111110000011111111111111111111111111111111111110000011111111111111111
111111111111111111111111111111111111111111111111111111111111111111111111111111111111111111111111111111111110000011111111111111111111111111111111111110000011111111111111111
111111111111111111111111111111111111111111111111111111111111111111111111111111111111111111111111111111111110000011111111111111111111111111111111111110000011111111111111111
111111111111111100000000000000001111000000000000000000000000000000000000000000000000000000000000000000000110000000000000000000000000000000000000000000000011111111111111111
111111111111111100000000000000001111000000000000000000000000000000000000000000000000000000000000000000000110000000000000000000000000000000000000000000000011111111111111111
111111111111111100000000000000001111000000000000000000000000000000000000000000000002000000000000000000000110000000000000000000000000000000000000000000000011111111111111111
111111111111111100000000000000001111007000000000000000000000000000000000002002000001200000000000000000000110000000000000000000000000000000000000000000000011111111111111111
111111111111111100022222222220001111222222222222622226222262222622222222555555222221166222222222222220000112000222222222222222222222222222222222222222000011111111111111111
111111111111111100001111111100001111111111111111111111111111111111111111111111111111111111111111111112000110000111111111111111111111111111111111111111000011111111111111111
111111111111111100001111111100001111000000000000000000000000000000000000000000000000000000000000000110000110000111110000000000000000000000000000000011200011111111111111111
111111111111111120001111111100021111000000000000000000000000000000000000000000000000000000000000000110000110002111112000000000000000000000000000000011000011111111111111111
111111111111111100001111111100001111000000000000000000000000000000000000000000000000000000000000000110002110000111111200000000000000000000000000700011000011111111111111111
111111111111111100001111111100001111000000000000000000000000000000000000000000000000000000000000000110000110000111111120000020002222222222222222222211000211111111111111111
111111111111111100021111111120001111222222222222222222222222222222222222222222222222222222222220000110000112000111111112000010000000000000000000000011000011111111111111111
111111111111111100001111111100001111111111111111111111111111111111111111111111111111111111111110002112000000000111111111200000000000000000000022220011000011111111111111111
111111111111111100001111111100001111111000000000000000000000000000000000000000000000000000000000000110000000000111111111120000000600000222000000000011200011111111111111111
111111111111111120001111111100021111100000000000000000000000000000000000000000000000000000000000066110000222222111111111112262622222255515552220000211000011111111111111111
111111111111111100001111111100001111000000000000000000000000000000000000000000000000000022222222222110000111111111111111111111111111111111111110000011000011111111111111111
111111111111111100001111111100001111000000000000000000000000000000000000000022222222222210000000000000000110000000000000000000000000000000000000000011000211111111111111111
111111111111111100021111111120001111000022222222222222222222222222222222222210000000000000000000000000002110000000000000000000000000000000000000000211000011111111111111111
111111111111111100001111111100001111200000000000000000000000000000000000000000000000000000000000000000000000000000000000000022222000000000222222000011000011111111111111111
111111111111111100001111111100001111000000000000000000000000000000000000000000000000000000000000000000000000000000000222220000100000000022111111000011200011111111111111111
111111111111111120001111111100021111000022222222222222222222222222222222222222222222222222222222222220002222222222255555515552125552222611111111666611000011111111111111111
111111111111111100001111111100001111000211111111111111111111111111111111111111111111111111111111111110000111111111111111111111111111111111111111111111000011111111111111111
111111111111111100001111111100001111000000000000000000000000000000000000000000000000000000000000000110000000000000000000000000000111111111111111111112222211111111111111111
111111111111111100021111111120001111200000000000000000000000000000000000000000000000000000000000000112000000000000000000000000000000000000011111111111111111111111111111111
111111111111111100001111111100000000000000000000000000000000000000000000000000000000000000000000000110000000000000000000000000000000000000000000000011111111111111111111111
111111111111111100001111111100000000000000000000000000000000000000000000000000000000000000000000000110000000000000000000000000000000000000000000000000000111111111111111111
111111111111111120001111111122222222222222222222222222222222222222222222222222222222222222222222200112222222222662662222222222222222222222222222222222220011111111111111111
111111111111111100001111111111111111111111111111111111111111111111111111111111111111111111111111000111111111111111111111111111111111111111111111111111110011111111111111111
111111111111111100000001110000000000000000000000000000000000000000000000000000000000000000000000000000000000000000000000000000000000000000000000000000000011111111111111111
111111111111111120000000112000000000000000000000000000000000000000000000000000000000000000000000000000000000000000000000000000000000000000000000000000000011111111111111111
111111111111111100000000011200000000000000000000000000000000000000000000000000000000000000000000000000000000000000000000000000000000000000000000000000000011111111111111111
111111111111111100000000001120000000000000000000000000000000000000000000000000000000000000000000000000000000000000000000000000000000000000000000000000000011111111111111111
111111111111111100222220000122222222222220002222222222222222222222222222222222222222222222222222220000222222222222222222222222222222222222222222222222220011111111111111111
111111111111111100111112000011111111111110001111111111111111111111111111111111111111111111111111110000111111111111111111111111111111111111111111111111110011111111111111111
111111111111111100111111200001000000000000000000000000000000000000000000000000000000000000000000000000000000000000000000000000000000000000000000000000010011111111111111111
111111111111111100100000020000100000000000000000000000000000000000000000000000000000000000000000000000000000000000000000000000000000000000000000000000010011111111111111111
111111111111111100100000002000010000000000000000000000000000000000000000000000000000000000000000000000000000000000000000000000000000000000000000000000015511111111111111111
111111111111111166111111111200001000000000000000000000000000000000000000000000000000000000000000000000000000000000000000000000000000000000000000000000011111111111111111111
111111111111111111111111111120000100000000000000000000000000000000000000000000000000000000000000000000000000000000000000000000000000000000000000000000000011111111111111111
111111111111111100000000000000000000000000000000000000000000000000000000000000000000000000000000000000000000000000000000000000000000000000000000000000000011111111111111111
111111111111111100000000000000000000000000000000000000000000000000000000000000000000000000000000000000000000000000000000000000000000000000000000000000000011111111111111111
111111111111111100000000000000000000000000000000000000000000000000000000000000000000000000000000000000000000000000000000000000000000000000000000000000000011111111111111111
111111111111111100000000000000000000000000000000000000000000000000000000000000000000000000000000000000000000000000000000000000000000000000000000000000000011111111111111111
111111111111111100000000000000000000000000000000000000000000000000000000000000000000000000000000000000000000000000000000000000000000000000000000000000000011111111111111111
111111111111111100000000000000000000000000000000000000000000000000000000000000000000000000000000000000000000000000000000000000000000000000000000000000000011111111111111111
111111111111111100000000000000000000000000000000000000000000000000000000000000000000000000000000000000000000000000000000000000000000000000000000000000000011111111111111111
111111111111111100000000000000000000000000000000000000000000000000000000000000000000000000000000000000000000000000000000000000000000000000000000000000000011111111111111111
111111111111111100000000000000000000000000000000000000000000000000000000000000000000000000000000000000000000000000000000000000000000000000000000000000000011111111111111111
111111111111111100000000000000000000000000000000000000000000000000000000000000000000000000000000000000000000000000000000000000000000000000000000000000000011111111111111111
111111111111111100000000000000000000000000000000000000000000000000000000000000000000000000000000000000000000000000000000000000000000000000000000000000000011111111111111111
111111111111111100000000000000000000000000000000000000000000000000000000000000000000000000000000000000000000000000000000000000000000000000000000000000000011111111111111111
111111111111111100000000000000000000000000000000000000000000000000000000000000000000000000000000000000000000000000000000000000000000000000000000000000000011111111111111111
111111111111111100000000000000000000000000000000000000000000000000000000000000000000000000000000000000000000000000000000000000000000000000000000000000000011111111111111111
111111111111111100000000000000000000000000000000000000000000000000000000000000000000000000000000000000000000000000000000000000000000000000000000000000000011111111111111111
111111111111111100000000000000000000000000000000000000000000000000000000000000000000000000000000000000000000000000000000000000000000000000000000000000000011111111111111111
111111111111111100000000000000000000000000000000000000000000000000000000000000000000000000000000000000000000000000000000000000000000000000000000000000000011111111111111111
111111111111111100000000000000000000000000000000000000000000000000000000000000000000000000000000000000000000000000000000000000000000000000000000000000000011111111111111111
111111111111111100000000000000000000000000000000000000000000000000000000000000000000000000000000000000000000000000000000000000000000000000000000000000000011111111111111111
111111111111111100000000000000000000000000000000000000000000000000000000000000000000000000000000000000000000000000000000000000000000000000000000000000000011111111111111111
111111111111111100000000000000000000000000000000000000000000000000000000000000000000000000000000000000000000000000000000000000000000000000000000000000000011111111111111111
111111111111111100000000000000000000000000000000000000000000000000000000000000000000000000000000000000000000000000000000000000000000000000000000000000000011111111111111111
111111111111111100000000000000000000000000000000000000000000000000000000000000000000000000000000000000000000000000000000000000000000000000000000000000000011111111111111111
111111111111111111111111111111111111111111111111111111111111111111111111111111111111111111111111111111111111111111111111111111111111100000011111111111111111111111111111111
111111111111111111111111111111111111111111111111111111111111111111111111111111111111111111111111111111111111111111111111111111111111111110111111111111111111111111111111111
111111111111111111111111111111111111111111111111111111111111111111111111111111111111111111111111111111111111111111111111111111111111111110111111111111111111111111111111111
111111111111111111111111111111111111111111111111111111111111111111111111111111111111111111111111111111111111111111111111111111111111111110111111111111111111111111111111111
111111111111111111111111111111111111111111111111111111111111111111111111111111111111111111111111111111111111111111111111111111111111111110111111111111111111111111111111111
111111111111111111111111111111111111111111111111111111111111111111111111111111111111111111111111111111111111111111111111111111111111111110111111111111111111111111111111111
111111111111111111111111111111111111111111111111111111111111111111111111111111111111111111111111111111111111111111111111111111111111111110111111111111111111111111111111111
111111111111111111111111111111111111111111111111111111111111111111111111111111111111111111111111111111111111111111111111111111111111111110111111111111111111111111111111111
111111111111111111111111111111111111111111111111111111111111111111111111111111111111111111111111111111111111111111111111111111111111111110111111111111111111111111111111111
111111111111111111111111111111111111111111111111111111111111111111111111111111111111111111111111111111111111111111111111111111111111111110111111111111111111111111111111111
111111111111111111111111111111111111111111111111111111111111111111111111111111111111111111111111111111111111111111111111111111111111111110111111111111111111111111111111111
111111111111111111111111111111111111111111111111111111111111111111111111111111111111111111111111111111111111111111111111111111111111111110111111111111111111111111111111111
111111111111111111111111111111111111111111111111111111111111111111111111111111111111111111111111111111111111111111111111111111111111111110111111111111111111111111111111111
111111111111111111111111111111111111111111111111111111111111111111111111111111111111111111111111111111111111111111111111111111111111111110111111111111111111111111111111111
111111111111111111111111111111111111111111111111111111111111111111111111111111111111111111111111111111111111111111111111111111111111111110111111111111111111111111111111111
111111111111111111111111111111111111111111111111111111111111111111111111111111111111111111111111111111111111111111111111111111111111111110111111111111111111111111111111111
111111111111111111111111111111111111111111111111111111111111111111111111111111111111111111111111111111111111111111111111111111111111111111111111111111111111111111111111111